账户模块	账户表	账户管理
        权限表	权限设置
        操作记录	操作记录
        系统消息	系统消息
用户模块	用户表	用户管理
        用户地址表	地址管理
        银行信息表	银行卡管理
        用户痕迹表	痕迹记录
        微信授权表	微信信息管理
商品模块	商品表	商品管理
        运费表	运费管理
        规格价格表	规格价格管理
订单模块	订单表	订单管理
	    发货表	发货管理
财务模块	充值表	充值流水
        提现表	提现流水
        推广收益表	推广收益流水
推广模块	推广表	推广管理
活动模块	活动表	活动管理
	    活动数据表	活动数据
系统模块	配置数据表	系统配置